11111111111111111111
1P00000W00C0000W0001
11101111101111110111
1C001000W010000010E1
1000110C0010C001W011
1W000000111000000001
11111000000001111101
1C00001111C000000001
10000100000111000111
1W000100C000001W0001
1C00000000100W0C0001
11111111111111111111
